Новый диван Манчестер угловой с подсветкой
Основные
Страна производитель	Россия
Тип дивана 	Классический каркасный
Наличие спального места 	Да
Тип спального места	для ежедневного сна
Угол дивана	взаимозаменяемый
Способ раскладывания дивана	вдоль
Механизм трансформации спального места 	Дельфин
Обивочный материал	рогожка, экокожа
Цвет	Бежевый
Узоры и принты	Без узоров и принтов
Ортопедические свойства 	Да
Гарантийный срок 	18 мес
Состояние	Новое
Габаритные размеры
Длина дивана	250 см
Глубина дивана	175 см
Высота дивана с учетом спинки	87 см
Размеры спального места
Длина спального места	200 см
Ширина спального места	150 см
Материал изготовления
Каркас дивана 	ЛДСП, натуральное дерево
Основание спального места 	ДВП
Подлокотник 	деревянный брус
Наполнители
Спальное место 	Да
Подушка сиденья 	пенополиуретан
Подушка спинки 	пенополиуретан
Комплектация
Ниша для белья 	1 шт.
Подлокотники 	Да
Декоративная подушка 	3 шт.
Дополнительные функции и характеристики
Сторона угла дивана 	взаимозаменяемый
Съемные подушки 	спинки
Пользовательские характеристики
Наполнитель	Пружинный блок, ППУ
Наличие подлокотников	Да
Сторона угла	Универсальный
Цвета	на выбор
Глубина, см	175
Ширина, см	250
Размер (глубина, см)	175
Срок доставки (дней)	6
Размер (высота, см)	87
Размер спального места (ширина, см)	150
Размер спального места (длина, см)	200
Стоимость дивана с размером спального места; 160*200 см.- 22400 руб.
Размер (ширина, см)	250
Высота спинки, см	87